00000000300000000000000000000
01111111111111111111111111110
01000000000000000000000000000
01111111111111111111111111110
01000000000000000000000000000
01111111111111111111111111110
01000000000000000000000000000
01111111111111111111111111110
01000000000000000000000000000
01111111111111111111111111110
01000000000000000000000000000
01111111111111111111111111110
01000000000000000000000000000
01111111111111111111111111110
01000000000000000000000000000
01111111111111111111111111110
01000000000000000000000000000
01111111111111111111111111110
01000000000000000000000000000
01111111111111111111111111110
01200000000000000000000000000
01111111111111111111111111110
01000000000000000000000000000
01111111111111111111111111110
01000000000000000000000000000
01111111111111111111111111110
01000000000000000000000000000
01111111111111111111111111110
01000000000000000000000000000
01111111111111111111111111110
